{
  "layers": [
    {
      "offsetX": 0,
      "offsetY": 0,
      "cells": [
        { "x": 0, "y": 0, "id": 2 },
        { "x": 1, "y": 0, "id":  6},
        { "x": 4, "y": 0, "id": 2 },
        { "x": 5, "y": 0, "id":  2},
        { "x": 0, "y": -1, "id":  6},
        { "x": -1, "y": -1, "id":  9},
        { "x": 1, "y": -1, "id":  5},
        { "x": 4, "y": -1, "id":  9},
        { "x": 5, "y": -1, "id":  10},
        { "x": 6, "y": -1, "id":  10},
        { "x": 0, "y": -2, "id":  9},
        { "x": 1, "y": -2, "id":  10},
        { "x": 2, "y": -2, "id": 4 },
        { "x": 2, "y": -1, "id":  4},
        { "x": 3, "y": -1, "id":  0},
        { "x": 3, "y": -2, "id":  0},
        { "x": 4, "y": -2, "id":  6},
        { "x": 5, "y": -2, "id":  5},
        { "x": 1, "y": -3, "id": 2 },
        { "x": 2, "y": -3, "id":  6},
        { "x": 3, "y": -3, "id":  6},
        { "x": 4, "y": -3, "id":  2},
        { "x": 2, "y": -4, "id":  0},
        { "x": 3, "y": -4, "id":  2}
      ]
    },
    {
      "offsetX": 1,
      "offsetY": 1,
      "cells": [
        { "x": 0, "y": 0, "id":  3},
        { "x": 4, "y": 0, "id":  4},
        { "x": 0, "y": -1, "id":  3},
        { "x": -1, "y": -1, "id": 4 },
        { "x": 1, "y": -1, "id": 3 },
        { "x": 3, "y": -1, "id":  4},
        { "x": 4, "y": -1, "id":  6},
        { "x": 5, "y": -1, "id":  7},
        { "x": -1, "y": -2, "id": 3 },
        { "x": 0, "y": -2, "id":  3},
        { "x": 1, "y": -2, "id":  3},
        { "x": 2, "y": -2, "id":  0},
        { "x": 3, "y": -2, "id":  4},
        { "x": 4, "y": -2, "id":  0},
        { "x": 5, "y": -2, "id": 0 },
        { "x": 0, "y": -3, "id":  7},
        { "x": 1, "y": -3, "id":  8},
        { "x": 2, "y": -3, "id":  8},
        { "x": 3, "y": -3, "id":  5},
        { "x": 4, "y": -3, "id":  7},
        { "x": 1, "y": -4, "id": 11 },
        { "x": 2, "y": -4, "id":  8},
        { "x": 3, "y": -4, "id":  11},
        { "x": 2, "y": -5, "id":  11}
      ]
    }
  ]
}
