{
  "layers": [
    {
      "offsetX": 5.25,
      "offsetY": -3.5,
      "cells": [
        { "x": 2, "y": 0, "id": 0 },
        { "x": 3, "y": 0, "id": 1 },
        { "x": 0, "y": -1, "id": 2 },
        { "x": 1, "y": -1, "id": 3 },
        { "x": 2, "y": -1, "id": 4 },
        { "x": 3, "y": -1, "id": 5 },
        { "x": 4, "y": -1, "id": 6 },
        { "x": 5, "y": -1, "id": 7 },
        { "x": 1, "y": -2, "id": 0 },
        { "x": 2, "y": -2, "id": 1 },
        { "x": 3, "y": -2, "id": 2 },
        { "x": 4, "y": -2, "id": 3 },
        { "x": 0, "y": -3, "id": 4 },
        { "x": 1, "y": -3, "id": 5 },
        { "x": 2, "y": -3, "id": 6 },
        { "x": 3, "y": -3, "id": 7 },
        { "x": 4, "y": -3, "id": 0 },
        { "x": 5, "y": -3, "id": 1 },
        { "x": 0, "y": -4, "id": 2 },
        { "x": 1, "y": -4, "id": 3 },
        { "x": 2, "y": -4, "id": 4 },
        { "x": 3, "y": -4, "id": 5 },
        { "x": 4, "y": -4, "id": 6 },
        { "x": 5, "y": -4, "id": 7 },
        { "x": 1, "y": -5, "id": 0 },
        { "x": 2, "y": -5, "id": 1 },
        { "x": 3, "y": -5, "id": 2 },
        { "x": 4, "y": -5, "id": 3 },
        { "x": 0, "y": -6, "id": 4 },
        { "x": 1, "y": -6, "id": 5 },
        { "x": 2, "y": -6, "id": 6 },
        { "x": 3, "y": -6, "id": 7 },
        { "x": 4, "y": -6, "id": 0 },
        { "x": 5, "y": -6, "id": 1 },
        { "x": 2, "y": -7, "id": 2 },
        { "x": 3, "y": -7, "id": 3 }
      ]
    },
    {
      "offsetX": 6.35,
      "offsetY": -4.5,
      "cells": [
        { "x": 0, "y": 0, "id": 4 },
        { "x": 1, "y": 0, "id": 5 },
        { "x": 2, "y": 0, "id": 6 },
        { "x": 3, "y": 0, "id": 7 },
        { "x": 4, "y": 0, "id": 0 },
        { "x": 1, "y": -1, "id": 1 },
        { "x": 2, "y": -1, "id": 2 },
        { "x": 3, "y": -1, "id": 3 },
        { "x": 0, "y": -2, "id": 4 },
        { "x": 1, "y": -2, "id": 5 },
        { "x": 2, "y": -2, "id": 6 },
        { "x": 3, "y": -2, "id": 7 },
        { "x": 4, "y": -2, "id": 4 },
        { "x": 0, "y": -3, "id": 5 },
        { "x": 1, "y": -3, "id": 6 },
        { "x": 2, "y": -3, "id": 7 },
        { "x": 3, "y": -3, "id": 4 },
        { "x": 4, "y": -3, "id": 5 },
        { "x": 0, "y": -4, "id": 6 },
        { "x": 1, "y": -4, "id": 7 },
        { "x": 2, "y": -4, "id": 4 },
        { "x": 3, "y": -4, "id": 5 },
        { "x": 4, "y": -4, "id": 6 },
        { "x": 1, "y": -5, "id": 7 },
        { "x": 2, "y": -5, "id": 4 },
        { "x": 3, "y": -5, "id": 5 },
        { "x": 0, "y": -6, "id": 6 },
        { "x": 1, "y": -6, "id": 7 },
        { "x": 2, "y": -6, "id": 4 },
        { "x": 3, "y": -6, "id": 5 },
        { "x": 4, "y": -6, "id": 6 }
      ]
    },
    {
      "offsetX": 7.5,
      "offsetY": -5.5,
      "cells": [
        { "x": 0, "y": 0, "id": 7 },
        { "x": 1, "y": 0, "id": 4 },
        { "x": 2, "y": 0, "id": 5 },
        { "x": 3, "y": 0, "id": 6 },
        { "x": 1, "y": -1, "id": 7 },
        { "x": 2, "y": -1, "id": 4 },
        { "x": 0, "y": -2, "id": 5 },
        { "x": 1, "y": -2, "id": 6 },
        { "x": 2, "y": -2, "id": 7 },
        { "x": 3, "y": -2, "id": 4 },
        { "x": 0, "y": -3, "id": 5 },
        { "x": 1, "y": -3, "id": 6 },
        { "x": 2, "y": -3, "id": 7 },
        { "x": 3, "y": -3, "id": 4 },
        { "x": 1, "y": -4, "id": 5 },
        { "x": 2, "y": -4, "id": 6 },
        { "x": 0, "y": -5, "id": 7 },
        { "x": 1, "y": -5, "id": 0 },
        { "x": 2, "y": -5, "id": 1 },
        { "x": 3, "y": -5, "id": 2 }
      ]
    },
    {
      "offsetX": 4.25,
      "offsetY": -4.5,
      "cells": [
        { "x": 3, "y": 0, "id": 3 },
        { "x": 2, "y": -1, "id": 0 },
        { "x": 3, "y": -1, "id": 1 },
        { "x": 4, "y": -1, "id": 2 },
        { "x": 1, "y": -2, "id": 3 },
        { "x": 3, "y": -2, "id": 0 },
        { "x": 5, "y": -2, "id": 1 },
        { "x": 0, "y": -3, "id": 2 },
        { "x": 1, "y": -3, "id": 3 },
        { "x": 2, "y": -3, "id": 0 },
        { "x": 3, "y": -3, "id": 1 },
        { "x": 4, "y": -3, "id": 2 },
        { "x": 5, "y": -3, "id": 3 },
        { "x": 6, "y": -3, "id": 0 },
        { "x": 1, "y": -4, "id": 1 },
        { "x": 3, "y": -4, "id": 2 },
        { "x": 5, "y": -4, "id": 3 },
        { "x": 2, "y": -5, "id": 0 },
        { "x": 3, "y": -5, "id": 1 },
        { "x": 4, "y": -5, "id": 2 },
        { "x": 3, "y": -6, "id": 3 }
      ]
    }
  ]
}