{
  "layers": [
    {
      "offsetX": 0,
      "offsetY": 0,
      "cells": [
        { "x": 0, "y": 0, "id": 32 },
        { "x": 1, "y": 0, "id":  18},
        { "x": 5, "y": 0, "id":  32},
        { "x": 6, "y": 0, "id":  18},
        { "x": 1, "y": -1, "id":  29},
        { "x": 2, "y": -1, "id":  12},
        { "x": 3, "y": -1, "id":  32},
        { "x": 4, "y": -1, "id":  20},
        { "x": 5, "y": -1, "id":  29},
        { "x": 2, "y": -2, "id":  32},
        { "x": 3, "y": -2, "id":  12},
        { "x": 4, "y": -2, "id":  18},
        { "x": 2, "y": -3, "id":  12},
        { "x": 3, "y": -3, "id":  32},
        { "x": 4, "y": -3, "id":  20},
        { "x": 2, "y": -4, "id":  17},
        { "x": 3, "y": -4, "id":  18},
        { "x": 4, "y": -4, "id":  24},
        { "x": 1, "y": -4, "id":  20},
        { "x": 5, "y": -4, "id":  17},
        { "x": 1, "y": -5, "id":  24},
        { "x": 5, "y": -5, "id":  17},
        { "x": 0, "y": -5, "id":  26},
        { "x": 6, "y": -5, "id":  24}
      ]
    },
    {
      "offsetX": 1,
      "offsetY": 1,
      "cells": [
        { "x": 0, "y": 0, "id":  11},
        { "x": 5, "y": 0, "id":  29},
        { "x": 1, "y": -1, "id":  11},
        { "x": 0, "y": -1, "id":  11},
        { "x": 4, "y": -1, "id":  32},
        { "x": 5, "y": -1, "id":  18},
        { "x": 1, "y": -2, "id":  20},
        { "x": 2, "y": -2, "id":  20},
        { "x": 3, "y": -2, "id":  18},
        { "x": 4, "y": -2, "id":  12},
        { "x": 2, "y": -3, "id":  14},
        { "x": 3, "y": -3, "id":  14},
        { "x": 1, "y": -4, "id":  12},
        { "x": 2, "y": -4, "id":  14},
        { "x": 3, "y": -4, "id":  12},
        { "x": 4, "y": -4, "id":  14},
        { "x": 0, "y": -5, "id":  14},
        { "x": 1, "y": -5, "id":  24},
        { "x": 2, "y": -5, "id":  14},
        { "x": 3, "y": -5, "id":  24},
        { "x": 4, "y": -5, "id":  24},
        { "x": 5, "y": -5, "id":  26},
        { "x": 0, "y": -6, "id":  26},
        { "x": 5, "y": -6, "id":  20}
      ]
    }
  ]
}
