{
  "layers": [
    {
      "offsetX": -1,
      "offsetY": -1,
      "cells": [
        { "x": 1, "y": 0, "id": 14 },
        { "x": 2, "y": 0, "id": 26 },
        { "x": 5, "y": 0, "id": 2 },
        { "x": 6, "y": 0, "id": 7 },
        { "x": 1, "y": -1, "id": 16 },
        { "x": 2, "y": -1, "id": 2 },
        { "x": 3, "y": -1, "id": 7 },
        { "x": 4, "y": -1, "id": 10 },
        { "x": 5, "y": -1, "id": 12 },
        { "x": 6, "y": -1, "id": 14 },
        { "x": 2, "y": -2, "id": 29 },
        { "x": 3, "y": -2, "id": 25 },
        { "x": 4, "y": -2, "id": 26 },
        { "x": 5, "y": -2, "id": 31 },
        { "x": 1, "y": -3, "id": 30 },
        { "x": 2, "y": -3, "id": 31 },
        { "x": 3, "y": -3, "id": 5 },
        { "x": 4, "y": -3, "id": 3 },
        { "x": 5, "y": -3, "id": 14 },
        { "x": 6, "y": -3, "id": 15 },
        { "x": 1, "y": -4, "id": 5 },
        { "x": 2, "y": -4, "id": 3 },
        { "x": 3, "y": -4, "id": 19 },
        { "x": 4, "y": -4, "id": 10 },
        { "x": 5, "y": -4, "id": 9 },
        { "x": 6, "y": -4, "id": 9 },
        { "x": 2, "y": -5, "id": 10 },
        { "x": 3, "y": -5, "id": 13 },
        { "x": 4, "y": -5, "id": 18 },
        { "x": 5, "y": -5, "id": 18 }
      ]
    },
    {
      "offsetX": 0,
      "offsetY": 0,
      "cells": [
        { "x": 1, "y": 0, "id": 11 },
        { "x": 2, "y": 0, "id": 1 },
        { "x": 4, "y": 0, "id": 3 },
        { "x": 5, "y": 0, "id": 4 },
        { "x": 0, "y": -1, "id": 2 },
        { "x": 1, "y": -1, "id": 7 },
        { "x": 2, "y": -1, "id": 8 },
        { "x": 3, "y": -1, "id": 19 },
        { "x": 4, "y": -1, "id": 9 },
        { "x": 5, "y": -1, "id": 10 },
        { "x": 6, "y": -1, "id": 16 },
        { "x": 1, "y": -2, "id": 12 },
        { "x": 2, "y": -2, "id": 15 },
        { "x": 3, "y": -2, "id": 13 },
        { "x": 4, "y": -2, "id": 18 },
        { "x": 5, "y": -2, "id": 17 },
        { "x": 1, "y": -3, "id": 23 },
        { "x": 2, "y": -3, "id": 21 },
        { "x": 3, "y": -3, "id": 22 },
        { "x": 4, "y": -3, "id": 25 },
        { "x": 5, "y": -3, "id": 26 },
        { "x": 0, "y": -4, "id": 27 },
        { "x": 1, "y": -4, "id": 28 },
        { "x": 2, "y": -4, "id": 29 },
        { "x": 3, "y": -4, "id": 30 },
        { "x": 4, "y": -4, "id": 31 },
        { "x": 5, "y": -4, "id": 32 },
        { "x": 6, "y": -4, "id": 14 },
        { "x": 1, "y": -5, "id": 11 },
        { "x": 2, "y": -5, "id": 1 },
        { "x": 3, "y": -5, "id": 5 },
        { "x": 4, "y": -5, "id": 3 },
        { "x": 5, "y": -5, "id": 6 },
        { "x": 2, "y": -6, "id": 7 },
        { "x": 4, "y": -6, "id": 10 }
      ]
    },
    {
      "offsetX": 1,
      "offsetY": 1,
      "cells": [
        { "x": 1, "y": -1, "id":  11},
        { "x": 4, "y": -1, "id":  32},
        { "x": 1, "y": -2, "id":  20},
        { "x": 0, "y": -2, "id":  20},
        { "x": 2, "y": -2, "id":  20},
        { "x": 3, "y": -2, "id":  18},
        { "x": 4, "y": -2, "id":  12},
        { "x": 5, "y": -2, "id":  12},
        { "x": 2, "y": -3, "id":  14},
        { "x": 3, "y": -3, "id":  14},
        { "x": 1, "y": -4, "id":  12},
        { "x": 0, "y": -4, "id":  12},
        { "x": 2, "y": -4, "id":  14},
        { "x": 3, "y": -4, "id":  12},
        { "x": 4, "y": -4, "id":  14},
        { "x": 5, "y": -4, "id":  14},
        { "x": 1, "y": -5, "id":  24},
        { "x": 2, "y": -5, "id":  14},
        { "x": 3, "y": -5, "id":  24},
        { "x": 4, "y": -5, "id":  24},
        { "x": 2, "y": -6, "id":  14},
        { "x": 3, "y": -6, "id":  24}
      ]
    }
  ]
}
