{
  "layers": [
    {
      "offsetX": -1.1,
      "offsetY": -0.85,
      "cells": [
        { "x": 3, "y": 0, "id": 0 },
        { "x": 4, "y": 0, "id": 1 },
        { "x": 2, "y": -1, "id": 2 },
        { "x": 3, "y": -1, "id": 3 },
        { "x": 4, "y": -1, "id": 4 },
        { "x": 5, "y": -1, "id": 5 },
        { "x": 1, "y": -2, "id": 6 },
        { "x": 2, "y": -2, "id": 7 },
        { "x": 3, "y": -2, "id": 8 },
        { "x": 4, "y": -2, "id": 9 },
        { "x": 5, "y": -2, "id": 0 },
        { "x": 6, "y": -2, "id": 1 },
        { "x": 0, "y": -3, "id": 2 },
        { "x": 1, "y": -3, "id": 3 },
        { "x": 2, "y": -3, "id": 4 },
        { "x": 3, "y": -3, "id": 5 },
        { "x": 4, "y": -3, "id": 6 },
        { "x": 5, "y": -3, "id": 7 },
        { "x": 6, "y": -3, "id": 8 },
        { "x": 7, "y": -3, "id": 9 },
        { "x": 0, "y": -4, "id": 0 },
        { "x": 1, "y": -4, "id": 1 },
        { "x": 2, "y": -4, "id": 2 },
        { "x": 3, "y": -4, "id": 3 },
        { "x": 4, "y": -4, "id": 4 },
        { "x": 5, "y": -4, "id": 5 },
        { "x": 6, "y": -4, "id": 6 },
        { "x": 7, "y": -4, "id": 7 },
        { "x": 2, "y": -5, "id": 8 },
        { "x": 3, "y": -5, "id": 9 },
        { "x": 4, "y": -5, "id": 0 },
        { "x": 5, "y": -5, "id": 1 },
        { "x": 6, "y": -5, "id": 2 },
        { "x": 1, "y": -5, "id": 3 },
        { "x": 2, "y": -6, "id": 4 },
        { "x": 3, "y": -6, "id": 5 },
        { "x": 4, "y": -6, "id": 6 },
        { "x": 5, "y": -6, "id": 7 },
        { "x": 1, "y": -7, "id": 8 },
        { "x": 2, "y": -7, "id": 9 },
        { "x": 3, "y": -7, "id": 0 },
        { "x": 4, "y": -7, "id": 1 },
        { "x": 5, "y": -7, "id": 2 },
        { "x": 6, "y": -7, "id": 3 },
        { "x": 0, "y": -8, "id": 4 },
        { "x": 1, "y": -8, "id": 5 },
        { "x": 2, "y": -8, "id": 6 },
        { "x": 3, "y": -8, "id": 7 },
        { "x": 4, "y": -8, "id": 8 },
        { "x": 5, "y": -8, "id": 9 },
        { "x": 6, "y": -8, "id": 0 },
        { "x": 7, "y": -8, "id": 1 },
        { "x": 1, "y": -9, "id": 2 },
        { "x": 6, "y": -9, "id": 3 }
      ]
    },
    {
      "offsetX": 0,
      "offsetY": 0,
      "cells": [
        { "x": 3, "y": 0, "id": 4 },
        { "x": 2, "y": -1, "id": 5 },
        { "x": 3, "y": -1, "id": 6 },
        { "x": 4, "y": -1, "id": 7 },
        { "x": 1, "y": -2, "id": 8 },
        { "x": 2, "y": -2, "id": 9 },
        { "x": 4, "y": -2, "id": 0 },
        { "x": 5, "y": -2, "id": 1 },
        { "x": 0, "y": -3, "id": 2 },
        { "x": 1, "y": -3, "id": 3 },
        { "x": 5, "y": -3, "id": 4 },
        { "x": 6, "y": -3, "id": 5 },
        { "x": 0, "y": -4, "id": 6 },
        { "x": 1, "y": -4, "id": 7 },
        { "x": 2, "y": -4, "id": 8 },
        { "x": 3, "y": -4, "id": 9 },
        { "x": 4, "y": -4, "id": 0 },
        { "x": 5, "y": -4, "id": 0 },
        { "x": 6, "y": -4, "id": 1 },
        { "x": 1, "y": -5, "id": 2 },
        { "x": 2, "y": -5, "id": 3 },
        { "x": 3, "y": -5, "id": 4 },
        { "x": 4, "y": -5, "id": 5 },
        { "x": 5, "y": -5, "id": 6 },
        { "x": 2, "y": -6, "id": 7 },
        { "x": 3, "y": -6, "id": 8 },
        { "x": 4, "y": -6, "id": 9 },
        { "x": 3, "y": -7, "id": 0 },
        { "x": 0, "y": -8, "id": 1 },
        { "x": 1, "y": -8, "id": 2 },
        { "x": 2, "y": -8, "id": 3 },
        { "x": 3, "y": -8, "id": 4 },
        { "x": 4, "y": -8, "id": 5 },
        { "x": 5, "y": -8, "id": 6 },
        { "x": 6, "y": -8, "id": 7 },
        { "x": 0, "y": -9, "id": 8 },
        { "x": 1, "y": -9, "id": 9 },
        { "x": 5, "y": -9, "id": 0 },
        { "x": 6, "y": -9, "id": 0 }
      ]
    }
  ]
} 
  